!!!!!!!!!!
!?   x   !
!x x x xx!
!* x   x !!!
!3xxxx x c !
!      x !!!
!xxx x   !
!  x x xx!
!   *   @!
!!!!!!!!!!