!!!!!!!!!!!!!!!!!!!!!
!?@@@x  z!          !
!x@x x xx!          !
!syx@ cx !!!!   @   !
! xxxx x    !       !
!  @   x x x!       !
!xxx x x x  !c   c  !
!  x x x xxxxxxxxxx !
!    x     @        !
!xxx x xxxxxxxxxxxx !
!@          x     c !
!!!!!!!!!!!!!!!!!!!!!