!!!!!!!!!!!!!!!!!!!!!
!   @x   !          !
!x x x xx!          !
!  x@ cx !!!!   @   !
! xxxx x    !       !
!t @   x x x!       !
!xxx x x x  !c   c  !
!  x x x xxxxxxxxxx !
!    x     @        !
!xxx x xxxxxxxxxxxx !
!@          x      ?!
!!!!!!!!!!!!!!!!!!!!!