!!!!!!!!!!!
!cx?  x   !
! xxx     !
! x   *   !
!         !
!    @    !
!  @    @ !
!!!!!!!!!!!